1111111111111111111111111
0001110000000000000000011
1101110011011111111111011
1101111001011100000111011
1001100000000001101110001
1011111011111111100110111
1011000011000000001110111
1000011000011111111110111
1111111110000000000001111
1111111111111001101111111
1001100000000000000000111
1101111011111111111111011
1101111001011100000111011
1001100000000001100110001
1011111011111111100110101
1011000011011100001110101
1101111011111111111111011
1101111001011100000111011
1001100000000001100110111
1011111011111111100110111
1011111011000000011111111
1011111011011100110000111
1011111011011100110110111
1011111000011100000110111
1111111111111111111110111