1111111111
0001110000
1101110011
1101111001
1001100001
1011111011
1011000011
1000011111
1111001111
1111111111
